. . . # . . . . G
. . # . . . # . .
. . . . . . . # .
# . # . # . . . #
. # . . . . . . .
. . . . . . # . #
. # . # . . . . .
. . . . # . # . .
S . . . . . . . .